{
  "width": 60,
  "height": 25,
  "seed": 13051300863100127324,
  "rooms": [
    {
      "x": 4,
      "y": 9,
      "w": 9,
      "h": 10
    },
    {
      "x": 15,
      "y": 2,
      "w": 6,
      "h": 5
    },
    {
      "x": 20,
      "y": 13,
      "w": 10,
      "h": 10
    },
    {
      "x": 23,
      "y": 4,
      "w": 7,
      "h": 6
    },
    {
      "x": 31,
      "y": 7,
      "w": 5,
      "h": 9
    },
    {
      "x": 38,
      "y": 14,
      "w": 5,
      "h": 7
    },
    {
      "x": 42,
      "y": 5,
      "w": 6,
      "h": 7
    },
    {
      "x": 44,
      "y": 13,
      "w": 8,
      "h": 4
    },
    {
      "x": 49,
      "y": 3,
      "w": 8,
      "h": 8
    }
  ],
  "tiles": [
    "############################################################",
    "############################################################",
    "###############......#######################################",
    "###############......############################........###",
    "###############......##.......###################........###",
    "###############......##.......############......#........###",
    "###############......##.......############......#........###",
    "##################.####.............######......#........###",
    "##################.####.......#.....####.................###",
    "####.........#####.####.......#.....####.#...............###",
    "####.........#####.######.#####.....####.#...............###",
    "####.........#####.######.#####.....####.#.......####.######",
    "####.........#####.######.#####.....####.#######.####.######",
    "####.........#####.#..........#.....####.###........#.######",
    "####...............#..........#.....##.....#........#.######",
    "####.........#####.#..........#.....##.....#..........######",
    "####.........#####.#..........###.####.....#........########",
    "####.........#####.#..........###..........#################",
    "####.........#####............########.....#################",
    "####################..........########.....#################",
    "####################..........########.....#################",
    "####################..........##############################",
    "####################..........##############################",
    "############################################################",
    "############################################################"
  ]
}